TILEMAP
212 14 							-- Size of tile map in tiles
32 							-- Tile size & block size
images/tileSheet.png 	-- Tilesheet
16 4 								-- Number of tiles in tilesheet
W W W W W W W W W W W W W W W W W W W W W W W W W W W W W W W W W W W W W W W W W W W W W W W W W W W W W W W W W W W W W W W W W W W W W W W W W W W W W W W W W W W W W W W W W W W W W W W W W W W W W W W W W W W W W W W W W W W W W W W W W W W W W W W W W W W W W W W W W W W W W W W W W W W W W W W W W W W W W W W W W W W W W W W W W W W W W W W W W W W W W W W W W W W W W W W W W W W W W W W W W W W W W W W W W W W W 
W W W W W W W W W W W W W W W W W W W W W W W W W W W W W W W W W W W W IAN MAN MAN DAN W W W W W W W W W W W W W W W W W W W W W W W W W W W IAN MAN DAN W W W W W W W W W W W W W W IAN MAN MAN DAN W W W W W W W W W W W W W W W W W W W W W W W W W W W IAN MAN DAN W W W W W W W W W W W W W W IAN MAN MAN DAN W W W W W W W W W W W W W W W W W W W W W W W W W W W IAN MAN DAN W W W W W W W W W W W W W W IAN MAN MAN DAN W W W W W W W W W W W W W W BOL W W W W W W W W W W W W W 
W W W W W W W W IAN MAN DAN W W W W W W W W W W W W W W W W IAN MAN MAN MAN DAN W W W W IDN MDN MDN DDN W W W W W W W W W W W W W W W W W W W W W W W W W W W IDN MDN DDN W W W W W IAN MAN MAN MAN DAN W W W W IDN MDN MDN DDN W W W W W W W W W W W W W W W W IAN MAN DAN W W W W W W W W IDN MDN DDN W W W W W IAN MAN MAN MAN DAN W W W W IDN MDN MDN DDN W W W W W W W W W W W W W W W W IAN MAN DAN W W W W W W W W IDN MDN DDN W W W W W IAN MAN MAN MAN DAN W W W W IDN MDN MDN DDN W W W W W W W W W W W W W W P W IAN MAN DAN W W W W W W W W W 
W W W W W W W W IDN MDN DDN W W W W W W W W W W W W W W W W IDN MDN MDN MDN DDN W W W W W W W W W W W W W W W W W W W W W W W W IAN MAN DAN W W W W W W W W W W W W W W W W IDN MDN MDN MDN DDN W W W W W W W W W W W W W W W W W W W W W W W W IDN MDN DDN W W W W W W W W W W W W W W W W IDN MDN MDN MDN DDN W W W W W W W W W W W W W W W W W W W W W W W W IDN MDN DDN W W W W W W W W W W W W W W W W IDN MDN MDN MDN DDN W W W W W W W W W W W W W W W W W W W W W W P W IDN MDN DDN W W W W W W W W W 
W W W W W W W W W W W W W W W W W W W W W W INTC W W W W W W W W W W W W W W W W W W W W W W W W W W W W W W W W W IDN MDN DDN W W W W W W W W W W W W W W W W W W W W W BR1 BR1 BR1 BR1 BR1 BR1 BR1 BR1 W W W BR1 BR1 BR1 INTC W W W W W W W W W W W W W W INTM W W W W W W W W W W W BR1 BR1 BR1 W W W W BR1 INTC INTC BR1 W W W W W W W W W W W W W W W W W W W W W W W W W W W W W W W W W W W W W W W W W W W W W W W W W W W W W W W W B B W W W W W W W W P W W W W W W W W W W W W W 
W W W W W W W W W W W W W W W W W W W W W W W W W W W W W W W W W W W W W W W W W W W W W W W W W W W W W W W W W W W W W W W W W W W W W W W W W W W W W W W W W W W W W W W W W W W W W W W W W W W W W W W W W W W W W W W W W W W W W W W W W W W W W W W W W W W W W W W W W W W W W W W W W W W W W W W W W W W W W W W W W W W W W W W W W W W W W W W W W W W W W W W W W W W B B B W W W W W W W W P W W W W W W W W W W W W W 
W W W W W W W W W W W W W W W W W W W W W W W W W W W W W W W W W W W W W W W W W W W W W W W W W W W W W W W W W W W W W W W W W W W W W W W W W W W W W W W W W W W W W W W W W W W W W W W W W W W W W W W W W W W W W W W W W W W W W W W W W W W W W W W W W W W W W W W W W W W W W W W W W W W W W W W W W W W W W W W W W W W W W W W W W W W W W W W W W W W W W W W W W W B B B B W W W W W W W W P W W W W W W W W W W W W W 
W W W W W W W W W W W W W W W W W W W W W W W W W W W W W W W W W W W W W W W W W W W W W W W W W W W W W W W W W W W W W W W W W W W W W W W W W W W W W W W W W W W W W W W W W W W W W W W W W W W W W W W W W W W W W W W W W W W W W W W W W W W W W W W W W W W W W W W W W W W W W W W W W W W W W W W W W W W W W W W W W W W W W W W W W W W W W W W W W W W W W W W W W B B B B B W W W W W W W W P W W W W IAC IAC IAC W W W W W W 
W W W W W W W W W W W W W W W W INTC W W W BR1 INTM BR1 INTC BR1 W W W W W W W W W W W W W W W W W W W W W IAT DAT W W W W W W W W W IAT DAT W W W W W W W W W W W W W W W W W W BR1 INTM BR1 W W W W W W W W W W W W W W INTC W W W W W BR1 INTS W W W W INTC W W INTC W W INTC W W W W W BR1 W W W W W W W W W W BR1 BR1 W W W W W W B W W B W W W W W W W W W W B B W W B W W W W W W W W W W W W BR1 BR1 INTC BR1 W W W W W W W W W W W W B B B B B B W W W W W W W W P W W W W IDC BRC DDC W W W W W W 
W W AM W W W W W W W W W W W W W W W W W W W W W W W W W W W W W W W W W W W IAT DAT W W W W W W IDT DDT W W AM W W W W W W IDT DDT W W W W W W W W W W W W W W W W W W W W W W W W W W W W W W W W W W W W W W W AM W W W W W W W W W W W W W W W W W W W W W W W W W W W W W W W W W W W W W B B W W B B W W W W AM W W W B B B W W B B W W W W W W W W W W W W W W W W W W W W W W W W W W B B B B B B B W W W W AM W W W P W W W IAC DAC DAC DAC IAC W W W W W 
W IM MM DM W W W W W W W W W W W W W AM W W W W W W W W W W IAT DAT W W W W W W W W IDT DDT W W W W W W IDT DDT W IM MM DM W W W W W IDT DDT W W W W W W AM W W W W W W W W W W W W W W W W W W W W W W W W W W W W W W W IM MM DM W W W W W W W W W W W W W AM W W W W W W W W W W W W W W W W W W W W W B B B W W B B B W W IM MM DM W B B B B W W B B B W W W AM W IAT DAT W W W W W W W W W W W W W W IAT DAT W B B B B B B B B W W W IM MM DM W W P W W W BRC BRC MAC BRC BRC W W AM W W 
IM MM GR MM DM W W W W W IAR MAR MAI MAR DAR W IM MM DM W W W W IAR MAR DAR W W IDT DDT W W W W W W W W IDT DDT W IAR MAR MAI DAR W IDT DDT IM MM GR MM DM W W W W IDT DDT IAR MAR MAI MAR DAR IM MM DM W W W W IAR MAR DAR W W W W W W W W W W W W W W W IAR MAR MAI DAR W W W IM MM GR MM DM W W W W W W IAR MAR MAI MAR DAR IM MM DM W W W W IAR MAR DAR W W W W W W W W W W W W B B B B MAR MAI B B B B IM MM GR MM B B B B B W W B B B B DAR IM MM DM IDT DDT W W IAR MAR DAR W W W W W W W W W IDT DDT B B B B B B B B B W W IM MM GR MM DM W B W W W BRC BRC MDC BRC BRC DAR IM MM DM W 
S S S S S S S S S S S S S S S S S S S S S S S S S S S S S S S S S S S S S S S S S S S S S S S S S S S S S S S S S S S S S S S S S S S S S W W S S S S S S S S S S S S S S W W W W S S S S S S S S S S S S S S S S S S S S S S S S S S S S S S S S S S S S S S S S S S S S S S S S S S S S S S S S S S S S S S S S W W S S S S S S S S S S S S S S S S S S S S S S S S S S S S S S S S S S S S S S S S S S S S S S S S S S S S S S S S S 
S S S S S S S S S S S S S S S S S S S S S S S S S S S S S S S S S S S S S S S S S S S S S S S S S S S S S S S S S S S S S S S S S S S S S W W S S S S S S S S S S S S S S W W W W S S S S S S S S S S S S S S S S S S S S S S S S S S S S S S S S S S S S S S S S S S S S S S S S S S S S S S S S S S S S S S S S W W S S S S S S S S S S S S S S S S S S S S S S S S S S S S S S S S S S S S S S S S S S S S S S S S S S S S S S S S S 
2 10 198  204 ---- ymin ymax xlim and xCastle of flag
18 -- Number of enemies
G 22 11
G 40 11
G 51 11
G 52 11
G 80 3
G 82 3
G 97 11
G 99 11
G 113 11
G 115 11
G 124 11
G 125 11
G 127 11
G 128 11
G 174 11 
G 176 11
K 107 11
K 14 10