TILEMAP
224 14 							-- Size of tile map in tiles
32 							-- Tile size & block size
images/tileSheet.png 	-- Tilesheet
16 2
W W W W W W W W W W W W W W W W W W W W W W W W W W W W W W W W W W W W W W W W W W W W W W W W W W W W W W W W W W W W W W W W W W W W W W W W W W W W W W W W W W W W W W W W W W W W W W W W W W W W W W W W W W W W W W W W W W W W W W W W W W W W W W W W W W W W W W W W W W W W W W W W W W W W W W W W W W W W W W W W W W W W W W W W W W W W W W W W W W W W W W W W W W W W W W W W W W W W W W W W W W W W W W W W W W W W W W W W W W W W W W W W 
W W W W W W W W W W W W W W W W W W W W W W W W W W W IAN MAN DAN W W W W W W W W W W W W W W W IAN MAN DAN W W W W W W W W W W W W W W W W W W W W W W W W W W W IAN MAN DAN W W W W W W W W W W W W W W W IAN MAN DAN W W W W W W W W W W W W W W W W W W W W W W W W W W W IAN MAN DAN W W W W W W W W W W W W W W W IAN MAN DAN W W W W W W W W W W W W W W W W W W W W W W W W W W IAN MAN DAN W W W W W W W W W W W W W W W W W W W W W W W W W W BOL W W W W W W W W W W W W W W W W W W W W W W W W 
W W W W W W W W W W W W W W W W W W IAN MAN DAN W W W W W W IDN MDN DDN IAN MAN MAN DAN W W W W W W W W W W W IDN MDN DDN IAN MAN MAN DAN W W W W W W W W W W W W W W IAN MAN DAN W W W W W W IDN MDN DDN IAN MAN MAN DAN W W W W W W W W W W W IDN MDN DDN W W W W W W W W W W W W W W W W W W W W W W W W W W W IDN MDN DDN IAN MAN MAN DAN W W W W W W W W W W W IDN MDN DDN IAN MAN MAN DAN W W W W W W W W W W W W W W IAN MAN DAN W W W W W IDN MDN DDN IAN MAN MAN DAN W W W W W W W W W W W W W W IAN MAN MAN DAN W W W W P W W W W W W W W W W W W W W W W W W W W W W W W 
W W W W W W W W W W W W W W W W W W IDN MDN DDN W W W W W W W W W IDN MDN MDN DDN W W W W W W W W W W W W W W IDN MDN MDN DDN W W W W W W W W W W W W W W IDN MDN DDN W W W W W W W W W IDN MDN MDN DDN W W W W W W W W W W W W W W IAN MAN MAN DAN W W W W W W W W W W W W W W IAN MAN DAN W W W W W W W W W IDN MDN MDN DDN W W W W W W W W W W W W W W IDN MDN MDN DDN W W W W W W W W W W W W W W IDN MDN DDN W W W W W W W W IDN MDN MDN DDN W W W W W W W W W W W W W W IDN MDN MDN DDN W W W W P W W W W W W W W W W W W W W W W W W W W W W W W 
W W W W W W W W W W W W W W W W W W W W W W W W W W W W INTC W W W W W W W W W W W W W W W W W W W W W W W W INTC INTC INTC INTC INTC W W W W W W W W W W W INTS BR1 BR1 BR1 W W W W W W W W BR1 BR1 BR1 BR1 INTC INTC INTC W W W W BR1 BR1 BR1 BR1 IDN MDN MDN DDN W W W W W W W W W W W W W W IDN MDN DDN W W W W W W W W INTM BR1 BR1 BR1 W W W W W W W W W W W W W W W W W W W W W W W W W W W W W W W W W W W BR1 BR1 BR1 BR1 W W W INTM W W W W W W W W W W W W W W W W W W W W W W W W W W W P W W W W W W W W W W W W W W W W W W W W W W W W 
W W W W W W W W W W W W W W W W W W W W W W W W W W W W W W W W W W W W W W W W W W W W W W W W W W W W W W W W W W W W W W W W W W W W W W W W W W W W W W W W W W W W W W W W W W W W W W W W W W W W W W W W W W W W W W W W W W W W W W W W W W W W W W W W W W W W W W W W W W W W W W W W W W W W W W W W W W W W W W W W W W W W W W W W W W W W W W W W W W W W W W W W W W W W W W W W W B W W W W W P W W W W W W W W W W W W W W W W W W W W W W W W 
W W W W W W W W W W W W W W W W W W W W W W W W W W W W W W W W W W W W W W W W W W W W W W W W W W W W W W W W W W W W W W W W W W W W W W W W W W W W W W W W W W W W W W W W W W W W W W W W W W W W W W W W W W W W W W W W W W W W W W W W W W W W W W W W W W W W W W W W W W W W W W W W W W W W W W W W W W W W W W W W W W W W W W W W W W W W W W W W W W W W W W W W W W W W W W W W B B W W W W W P W W W W W W W W W W W W W W W W W W W W W W W W 
W W W W W W W W W W W W W W W W W W W W W W W W B W W W W W W W W W W W W W W W W W W W W W W W W W W W W W W W W W W W W W W W W W W W W W W W W W W W W W W W W W W W W W W W W W W W W W W W W W W W W W W W W W W W W W W W W W W W W W W W W W W W W W W W W W IAT DAT W W W W W W W W W W W W W W W W W W W W W W W W W W W W W W W W W W W W W W W W W W W W W W W W W W W W W W W W W W W B B B W W W W W P W W W IAC IAC IAC W W W W W W W W W W W W W W W W W W 
W W W W W W W W W W W W W W W BR1 INTM BR1 W W W W W B B W W W INTC W W W W W B W W W W W IAT DAT W W W W W W W W W W W INTM INTC INTC INTC INTC W W W W W W W W W W BR1 W W W W W IAT DAT W W W INTC INTC INTC INTC W W W W W W W W W W W W W W W W W W W W IAT DAT W W W W W W W W W W W W W W W W W IAT DAT W W W W W W IDT DDT W W W W W W W W W W W W W W W W W W W W W W W W W W W W W INTC W W W W W W W INTC W W W W W W W W W W W W W W BR1 BR1 W W W W B B B B W W W W W P W W W IDC BRC DDC W W W W W W W W W W W W W W W W W W 
W W W W W W W W W W W W W W W W W W W W W W B B B W W W W W W W W W B W W W W W IDT DDT W W W W W W W W W W W W W W W W W W W W W W W W W W W W W W W W IDT DDT W W W W W W W W W W W W W W W W W W W W W W W W W W W IDT DDT W W W W W W W W W W W W W W W W W IDT DDT W W IAT DAT W W IDT DDT W W W W W W W W W W W W W W W W W W W W W W B W W W W W W W W W W W W W W W W W W W W IAT DAT W W W W W W W W W W W W B B B B B W W W W W P W W IAC DAC DAC DAC IAC W W W W W W W W W W W W W W W W W 
W W W W W W W W W W W W W W W W W W W W W B B B B W W W W W W W W W B B W W W W IDT DDT W W W W W W W W W W W W W W W W W W W W W W W W W W W W W W W W IDT DDT W W W W W W W W W W W W W W W W W W W W W W W W W W W IDT DDT W W W W W W W W W W IAT DAT W W W W W IDT DDT W W IDT DDT W W IDT DDT W W W W W W W W W W W W W W W W W W W W W W B W W W W W W W W W W W W W W W W W W W W IDT DDT W W W W W W W W W W W B B B B B B W W W W W P W W BRC BRC MAC BRC BRC W W AM W W W W W W W W W W W W W W 
W W W W W W W W W W W W W W W W W W W W B B B B B W W W W W W W W W B B W W W W IDT DDT MAR MAR DAR W W W W W W W W W W W W W W W W W W W W W W W W W W W W W IDT DDT W W W W W W W W W W W W W W W W W W W W W W W W W W W IDT DDT W W W W W W W W W W IDT DDT W W W W W IDT DDT W W IDT DDT W W IDT DDT W W W W W W W W W W W W W W W W W W W W W W B W W W W W W W W W W W W W W W W W W W W IDT DDT W W W W W W W W W W B B B B B B B W W W W W B W W BRC BRC MDC BRC BRC DAR IM MM DM W W W W W W W W W W W W W 
S S S S S S S S S S S S S S S S S S S S S S S S S S S S S S S S S S S S S S S S S S S S S S S S S S S S S S S S S S S S S S S S S S S S S S S S S S S S S S S S S S S S S S S S S S S S W W W W S S S S S S S S S S W W W S S S S S S S S S S S S S S S S S S S S S S S S S S S S S S W W W S S S S S S S S S S W W S S S S S S S S S S S S S S S S S S S S S S S S S S S S S S S S S S S S S S S S S S S S S S S S S S S S S S S S S S S S S S S S S S S S S S 
S S S S S S S S S S S S S S S S S S S S S S S S S S S S S S S S S S S S S S S S S S S S S S S S S S S S S S S S S S S S S S S S S S S S S S S S S S S S S S S S S S S S S S S S S S S S W W W W S S S S S S S S S S W W W S S S S S S S S S S S S S S S S S S S S S S S S S S S S S S W W W S S S S S S S S S S W W S S S S S S S S S S S S S S S S S S S S S S S S S S S S S S S S S S S S S S S S S S S S S S S S S S S S S S S S S S S S S S S S S S S S S S  
2 10 199 204
25
G 24 6
K 32 11
K 33 11
G 42 11
G 44 11
K 55 7
G 59 11
G 60 11
K 66 11
G 68 11
G 70 11
G 72 11
G 87 11
G 88 11
G 90 11
G 103 7
G 115 9
G 120 11
K 137 11
K 150 9
G 161 11
G 162 11
K 168 11
K 170 11
K 184 11